NO ./textures/wood.xpm
SO ./textures/wood.xpm
WE ./textures/wood.xpm
EA ./textures/wood.xpm

F 220,100,0
C 225,30,1

1111111111111111
1001100111000001
1010010100000001
1011110111000001
1010010001000001
1010010111000001
1000000000000001
1011011001100001
1010101010010001
1010101011110001
1010001010010001
1010001010010001
1000000000000N01
1000000000000001
1000000000000001
1111111111111111