NO ./textures/wood.xpm
SO ./textures/wood.xpm
WE ./textures/wood.xpm
EA ./textures/wood.xpm

F 220,100,0
C 225,30,1

1111111111111111
1001100000000001
1010010000000001
1011110000000001
1010010000000001
1000000000000001
1000000000000001
1000001010000001
1000000100000001
1000001010000001
1000000000000001
10000N0000100101
1000000000100101
1000000000100101
1000000000111101
1111111111111111