NO ./textures/PORCELAINBRICKS.xpm
SO ./textures/REDBRICKS.xpm
WE ./textures/ROUNDBRICKS.xpm
EA ./textures/SLIMBRICKS.xpm
DO ./textures/CREAKYDOOR.xpm

F 189,186,187
C 135,206,235

11111111111111111111111111111111
10000000000000000000000000000001
10000000000000000000000000000001
10000000000111100000000000000001
10000000000100100000000000000001
10000000000100100000000000000001
10000000000121100000000000000001
10000000000000000000000000000001
10000000000000000000000000000001
10000000000000000000000000000001
10000000000000000000000000000001
10000000000000000000000000000001
10000000000000000000000000000001
10000000000000000000000000000001
10000000000000000000000000000001
10000000000000000000000000000001
10000000000000000000000000000001
10000000000001111111111111111111
10000000000001000000000000000001
10000000000001000000000000000001
11111111111111112111111100000001
10000000000001000000000100000001
10000000000002000000000100000001
10000000000001000000000111121111
11111111111111000000000100000001
10000000000001000000000100000001
10000000000002000000000100000001
100000000000010000000001000N0001
11111111111111000000000100000001
10000000000002000000000100000001
10000000000001000000000100000001
11111111111111111111111111111111