NO ./textures/wall1.xpm
SO ./textures/wall2.xpm
WE ./textures/wall3.xpm
EA ./textures/wall4.xpm

F 189,186,187
C 135,206,235

11111
10001
10N01
10001
11111