NO ./textures/wood.xpm
SO ./textures/wood.xpm
WE ./textures/wood.xpm
EA ./textures/wood.xpm

F 189,186,187
C 135,206,235

1111111111111111
1001000000000001
1001000000000001
1001000000000001
1001000000000001
1001000000000001
1001000000000001
1001000000000001
1000000N00000001
1000000000000001
1000000000000001
1000000000011001
1000000000011001
1000000000000001
1000000000000001
1111111111111111