NO ./textures/wall1.xpm
SO ./textures/wall2.xpm
WE ./textures/wall3.xpm
EA ./textures/wall4.xpm

F 189,186,187
C 135,206,235

1111111111111111
1001000000000001
1001000000000001
1001000000000001
1001000000000001
1001000000000001
1001000000000001
1001000000000001
1000000000000001
1000000000000001
1000000000000001
100000S000011001
1000000000011001
1000000000000001
1000000000000001
1111111111111111