NO ./textures/wood.xpm
SO ./textures/wood.xpm
WE ./textures/wood.xpm
EA ./textures/wood.xpm

F 220,100,0
C 225,30,1

1111111111111111
1010000000000001
1010000000000001
1011111000000001
1000001000000001
1000001000000001
1000001000000001
1000000000000001
100000N000000001
1000000000000001
1000000000000111
1000000000000001
1000000000000001
1000000000000001
1000000000000001
1111111111111111